[][][][][][][][][][][]
[]s []          []  []
[]  []  []  []  []  []
[]  []  []  []      []
[]  [][][]  [][][]  []
[]          []  []  []
[][][][][][][]  []  []
[]  []          []  []
[]  []  []  [][][]  []
[]      []         f[]
[][][][][][][][][][][]
